XXXXXXXXXXXXXXXXXXXXXXXXXXXXXXXXXXXXXXXXXXXXXXXXXXXXXXXXXXXXXXXX
X                                                              X
X                                                              X
X                                                              X
X                                                              X
X                                                              X
X                                                              X
X                                                              X
X                                                              X
X                                                              X
X                                                              X
X                                                              X
X                                                              X
X                                                              X
X                                                              X
X                                                              X
X               XXXXXXXXXXXX                                   X
X               XXXXXXXXXXXX                                   X
X               XXXXXXXXXXXX                                   X
X           XXXXXXXXXXXXXXXX                                   X
X           XXXXXXXXXXXXXXXX                                   X
X           XXXXXXXXXXXXXXXX                                   X
X           XXXXXXXXXXXXXXXX                                   X
X                                                              X
X                                                              X
X                                                              X
X                                                              X
X                                                              X
X                                                              X
X                                                              X
X                                                              X
XXXXXXXXXXXXXXXXXXXXXXXXXXXXXXXXXXXXXXXXXXXXXXXXXXXXXXXXXXXXXXXX
