XXXXXXXXXXXXXXXXXXXXXXXXXXXXXXXXXXXXXXXXXXXXXXXXXXXXXXXXXXXXXXXX
X                                                              X
X                                                              X
X                                                              X
X                                                              X
X                                                              X
X        XXXXXX                                                X
X        XXXXXX                                                X
X        XXXXXX                                                X
X                                                              X
X                                                              X
X                                                              X
X                                                              X
X                           XXXXXXXXX                          X
X                           XXXXXXXXX                          X
X                           XXXXXXXXX                          X
X                           XXXXXXXXX                          X
X                           XXXXXXXXX                          X
X                                                              X
X                                                              X
X                                                              X
X                                                              X
X                                                              X
X                                                              X
X                                                              X
X                                                              X
X                              XXXXXXXXXXXXXXXXXXXXXXX         X
X                              XXXXXXXXXXXXXXXXXXXXXXX         X
X                                                              X
X                                                              X
X                                                              X
XXXXXXXXXXXXXXXXXXXXXXXXXXXXXXXXXXXXXXXXXXXXXXXXXXXXXXXXXXXXXXXX
